10
9
+-------+
|   |   |
| |   | |
| +---+ |
| |     |
|-+ + +-|
|   | | |
| | +-+ |
| |     |
+-------+